|-----------------------------------------------------------------------------|
|  |-----------------|       |--------------------------------------|         |
|  |00000000000000000|       |22222222222222222222222222222222222222+#####    |
|  |00000000000000000|       |22222222222222222222222222222222222222|    #    |
|  |00000000000000000|       |22222222222222222222222222222222222222|    #    |
|  |00000000000000000|       |22222222222222222222222222222222222222| |--+---||  
|  |--------+--------|       |222222222222222222222222222222222|----| |333333||
|           #                |222222222222222222222222222222222|-|    |333333||
|           #################+22222222222222222222222222222222222|-|  |333333||
|                #           |2222222222222222222222222222222222222|  |333333||
|                #           |-------------------------------------|  |333333||
|           ########                                                  |333333||
|           #   #  |------|            |------------------------------|333333||
|           #   #  |111111|        ####+3333333333333333333333333333333333333||
||----------+---+--|111111|        #   |3333333333333333333333333333333333333||
||111111111111111111111111|        #   |------------------------------|333333||
||111111111111111111111111|        #                                  |333333||
||111111111111111111111111|        #    |---------------------|       |------||
||111111111111111111111111|      #######+444444444444444444444|               |
||111111111111111111111111|        #    |444444444444444444444|--------------||
||111111111111111111111111|        #    |444444444444444444444444444444444444||
||111111111111111111111111|        #    |444444444444444444444444444444444444||
||------------------------+#############+44444444444444444444|---------------||
|                                       |--------------------|                |
|-----------------------------------------------------------------------------|