|-----------------------------------------------------------------------------|
|  |-----------------------------    -------------------------------|         |
|  |00000000000000000000000000000|  |3333333333333333333333333333333+#####    |
|  |00000000000000000000000000000+##+3333333333333333333333333333333|    #    |
|  |00000000000000000000000000000|  |3333333333333333333333333333333|    #    |
|  |00000000000000000000000000000|  |3333333333333333333333333333333|    #    |
|  |--------+------------|0000000|  |3333333333333333333333333333333|    #    |
|           #            |-------|  |-------------------------------|    #    |
|           #################+-------------------------------------------+---||
|                #           |22222222222222222222222222222222222222222222222||
|                #           |22222222222222222222222222222222222222222222222||
|           ########         |---------|2222222222222222222222222222222222222||
|           #   #  |------|            |2222222222222222222222222222222222222||
|           #   #  |111111|        ####+2222222222222222222222222222222222222||
||----------+---+--|111111|        #   |2222222222222222222222222222222222222||
||111111111111111111111111|        #   |------------------------------|222222||
||111111111111111111111111|        #                                  |222222||
||111111111111111111111111|        #    |---------------------|       |------||
||111111111111111111111111|      #######+444444444444444444444|               |
||111111111111111111111111|        #    |444444444444444444444|--------------||
||111111111111111111111111|        #    |444444444444444444444444444444444444||
||111111111111111111111111|        #    |444444444444444444444444444444444444||
||------------------------+#############+44444444444444444444|---------------||
|                                       |--------------------|                |
|-----------------------------------------------------------------------------|